
NO ./assets/red.xpm

EA ./assets/eagle.xpm

WE 	./assets/greystone.xpm

SO  ./assets/purplestone.xpm

F   100,100,50
C   128,208,208

        1111111111111111111111111
        1000000000110000000000001
        1011000001110000000000001
        10010000000P000000W000001
111111111011000001110000000000001
10000000001100000111011111P111111
1111011111111101110001111000111
111101111111110111011	10010001
1100000011011101110001111000111
10000000000000001100000010001
10000000000000001101010010001
11000001110101011111011110001
11110111 1110101 101111010001
11111111 1111111 111111111111
