
NO ./assets/wall_1.xpm

EA ./assets/wall_3.xpm

WE ./assets/wood.xpm

SO  ./assets/wall_2.xpm

F   82,84,88
C   13,49,75

        1111111111111111111111111
        100P000000110000000000001
        1011000001110000000000001
        10010000000P000000W000001
111111111011000001110000000000001
10000000001100000111011111P111111
11110111111111P1110001111000111
111101111111110111011	10010001
1100000011011101110001111000111
10000000000000001100000010001
10000000000000001101010010001
11000001110101011111011110001
11110111 1110101 101111010001
11111111 1111111 111111111111
