
NO ./assets/red.xpm

EA ./assets/eagle.xpm

WE ./assets/greystone.xpm

SO ./assets/purplestone.xpm

F 220,100,0
C 225,30,0

                        1111111111111111111111111
                        1000000000110000000000001
                        1011000001110000000000001
                        10010000000000000W0000001
                111111111011000001110000000000001
                100000000011000001110111111111111
                11110111111111011100000010001
                11110111111111011101010010001
111111111111111111000000110111011100000010001
100000000000000000000000000000001100000010001
111111111111111110000000000000011010100100001
                11000001110101011111011110001
                11110111 1110101 101111010001
                11111111 1111111 111111111111
