
NO ./assets/greystone.xpm

EA ./assets/purplestone.xpm

WE ./assets/red.xpm

SO  ./assets/wood.xpm

F   82,84,88
C   13,49,75

1111111111111111111
1001001001001001001
1001001001001001001
1001001001001001001
1001001000001001001
100000000W000000001
1000011111111000001
1111000000000001111
1000000101010000001
1111111111111111111