
NO ./assets/greystone.xpm

EA ./assets/purplestone.xpm

WE ./assets/red.xpm

SO  ./assets/wood.xpm

F   82,84,88
C   13,49,75

111111111111111111111111
100000000000000000010001
100000000000000000010001
100000000S000000000P0001
100000000000000000010001
100000000000000000010001
100000000000000000010001
10000011P110000101010001
100000100010000000000001
100000100010000100010001
100000100010000000000001
100000111100001010100001
100000000000000000000001
100000000000000000000001
100000000000000000000001
100000000000000000000001
100000000000000000000001
100000000000000000000001
100000000000000000000001
111111111000000000000001
100100001000000000000001
100P00101000000000000001
100100001000000000000001
100111111000000000000001
100000000000000000000001
100000000000000000000001
111111111111111111111111